1111111111111111
1P00000000000001
1000000000000001
1000000000000011
1000000000000EC1
1000000000000101
1000000000000101
1000000000000001
1111111111111111