111111111111111111111111111111111111111111111111111111111111
1000P0000000000000000000000000000000000000000000000000000001
100000000000000000000000000000000000000000000000000000000001
100001111111111111111111111111111111111111111111111111100001
100001000000000000000000000000000000000000000000000000100001
100001001100000111000011100001110000000000010100011100100001
100001000100000001000000100000010000000000010100000100100001
100001000100000111000011100000010000111000011100011100100001
100001000100000001000000100000010000000000000100010000100001
100001001110000111000011100000010000000000000100011100100001
100001000000000000000000000000000000000000000000000000100001
100001111111111111111111111111111111111111111111111111100001
100000000000000000000000000000000000000000000000000000000001
100000000000000000000000000000000000000000000000000000000CE1
111111111111111111111111111111111111111111111111111111111111