111111111111111111111111111111111111111111111111111111111111
1111P0000000000000000000000000000000000000000000000000000001
111100011111111111111111111111111111111111111111111111111111
111100000000000000000000000000000000000000000000000000000001
111111011111111111111111111111111111111111111111111111111111
111100000000000000000000000000000000000000000000000000000001
111100011111111111111111111111111111111111111111111111111111
111100010000000000000000000000000000000000000000000000000001
111100000000000000000000000000000000000000000000000000000001
111100000000000000000000000000000000000000000000000000000001
111100000000000000000000000000000000000000000000000000000001
111111111111111111111111111111111110111111111111111111111111
111111000000000000000000000000000000000000000000000000000001
111100011111111110111111111111111111111111111111111111111111
111100010000000000000000000000000000000000000000000000000001
111100000000000000000000000000000000000000000000000000000001
111111111111111111111111111101111111111111111111111111111111
111100000000000000000000000000000000000000000000000000000001
111100000000000000000000000000000000000000000000000000000001
111100011111111111111111111001111111111111111111111111111111
111111111111111111111111110001111111111111111111111111111111
111100000000000000000000000000000000000100010000000000000001
111100011111111111111111111111111111111111111111111111111111
111100000000000000000000000000000000000000000000000000000CE1
111111111111111111111111111111111111111111111111111111111111