1111111111111
100100CCCCCC1
100100CCCCCC1
100100CCCCCC1
100100CCCCCC1
100100CCCCCC1
100100CCCCCC1
100100CCCCCC1
100100CCCCCC1
100100CCCCCC1
100100CCCCCC1
10000111110C1
1P0011E000001
1111111111111