1111111111
10000C0001
1001110001
10C10100C1
10C1110C01
11PE0C0001
1111111111