111111111111111111111111111111111111111111111111111111111111
1P000000000000000000000000000000000000000CCH0C00000000000001
10000000CCH0CCH0C00000000000000000000000000000000CCH0C000001
100000000000000CCH0C0000CCH0C0000000000000000000000000000001
10000CCH0C00000000000000000000000000000000000000000000000001
100000000000000000000000000000000CCH0C0000000000000000000001
1000000000000CCH0C00000000CCH0C00000000000000000000000000001
100CCH0C0CCH0C00000000000000000000000CCH0C00CCH0C00000000001
1000000000000000CCH0C0000000CCH0C000000000000000000CCH0C0001
100000000000000000000000000000000000000000000000000000000001
10000000000000000000000000000000000000CCH0C00000000000000001
100000000000000000000000000000000000000000000000000000000001
1000000CCH0C000000000000CCH0C0000000000000000000000CCH0C0001
100000000000000000000000000000000000000000000CCH0C0000000001
100000000000000000CCH0C00000CCH0C00000000000000000000CCH0C01
100000000000000000000000000000000000000000000000000000000001
100CCH0C000000000000000000000000000000CCH0C0000000CCH0C00001
100000000000000000000000000000000000000000000000000000000001
10000CCH0C00CCH0C0000CCH0C00000000000000000000CCH0C000000001
100000000000000000000000000000000000000CCH0C0000000000000001
1000000000000000000000000000CCH0C000000000000000000000CCH0C1
100000000000000000000000000000000000000000000000000000000001
1CCH0C000000000000000000000000000000000000000000000000000001
10000000000000CCH0C00000000000000000000CCH0C00000CCH0C000001
100000000000000000CCH0C0000000000000000000000000000000000001
10000000000CCH0C00000000000000000000000000000000000000000001
1000000000000000000000000000000000000000000000000CCCCC0C0001
100000000000CCH0C0000000000000000000000000000000000000000001
1000000000000000000000CCH0C00CCH0C00000000000000000000000001
100000000000000000000000000000000000000000000000000000000001
1000000000000000000000000000000000000000000000000000000000E1
111111111111111111111111111111111111111111111111111111111111