111111111111111111111111111111111111111111111111111111111111
1P0000000000000000000000000000000000000000000000000000000001
1CCCCCCCCCCCCCCCCCCCCCCCCCCCCCCCCCCCCCCCCCCCCCCCCCCCCCCCCCC1
100000000000000CC00C0000CC00C0000000000000000000000000000001
100000000000000000000000000000000000000000000000000000000001
100000000000000000000000000000000000000000000000000000000001
100000000000000000000000000000000000000000000000000000000001
100000000000000000000000000000000000000000000000000000000001
100000000000000000000000000000000000000000000000000000000001
100000000000000000000000000000000000000000000000000000000001
100000000000000000000000000000000000000000000000000000000001
100000000000000000000000000000000000000000000000000000000001
100000000000000000000000000000000000000000000000000000000001
100000000000000000000000000000000000000000000000000000000001
100000000000000000000000000000000000000000000000000000000001
100000000000000000000000000000000000000000000000000000000001
100000000000000000000000000000000000000000000000000000000001
100000000000000000000000000000000000000000000000000000000001
100000000000000000000000000000000000000000000000000000000001
100000000000000000000000000000000000000000000000000000000001
100000000000000000000000000000000000000000000000000000000001
100000000000000000000000000000000000000000000000000000000001
100000000000000000000000000000000000000000000000000000000001
1000000000000000000000000000000000000000000000000H0000000001
100000000000000000000000000000000000000000000000000000000001
100000000000000C00000000000000000000000000000000000000000001
1000000000000000000000000000000000000000000000000CCCCC0C0001
100000000000CC00C0000000000000000000000000000000000000000001
1000000000000000000000CC00C00CC00C00000000000000000000000001
100000000000000000000000000000000000000000000000000000000001
1000000000000000000000000000000000000000000000000000000000E1
111111111111111111111111111111111111111111111111111111111111